NO ./path_to_the_north_texture
SO ./path_to_the_south_texture

WE ./path_to_the_west_texture

EA ./path_to_the_east_texture
F 220,100,0

C 225,30,0
1111111111
1000000001
1000000001
10000000011
10000111001
10000000011
1000000001
10000000S1
1000000001
1111111111
