       11111111
      1000000N01
    111000000001
1111100000000001
1000000000000001
1000000000000001
1000000000000001
111111111111111
1100001
111111
